+-+-+-+-+-+-+-+-+-+
|     | |   | | | |
+ + + + + + + + + +
| | | | | |     | |
+ + + + +-+ + +-+ +
| | |       | |   |
+-+ +-+-+ + +-+-+ +
| | | |   | |     |
+ + + +-+-+-+ + + +
| |   |   |   | | |
+ + + + + +-+ +-+-+
|   | | |   | | | |
+ + + + + +-+ + + +
| | |   | |   |   |
+ +-+-+-+ +-+ + +-+
|   |         | | |
+ + +-+-+-+ +-+ + +
| |       |       |
+-+-+-+-+-+-+-+-+-+
