+-+-+-+-+-+-+-+-+-+-+
| |         | | | | |
+ + + +-+ +-+ + + + +
|   |   | | |   |   |
+ + +-+-+ + + +-+-+ +
| |   | |       | | |
+ + +-+ + +-+ + + + +
| | |     |   |     |
+-+-+ +-+ +-+ + +-+ +
|     | | |   |   | |
+ +-+ + + +-+-+ +-+ +
|   |   | |   | |   |
+-+-+ + + + + + + + +
| |   |   | | | |   |
+ +-+-+ +-+ +-+ +-+ +
| | | |         | | |
+ + + +-+-+ +-+ + + +
| | |     |   | | | |
+ + + +-+ + + + + + +
|       |   |       |
+-+-+-+-+-+-+-+-+-+-+
